; NON-PLATED HOLES START AT T1
; THROUGH (PLATED) HOLES START AT T100
M48
INCH
T1C0.086614
T100C0.042000
T101C0.030000
T102C0.027559
T103C0.036111
T104C0.035000
T105C0.043307
%
T1
X021000Y000986
X001000Y012986
X021000Y012986
X001000Y000986
T100
X007000Y002986
X007000Y003986
X007000Y001986
T101
X007000Y007986
X007000Y008986
X007000Y006986
T102
X013000Y001986
X009000Y003986
X013000Y002986
X009000Y002017
T103
X011000Y007986
X020000Y007986
X011000Y008986
X020000Y008986
X011000Y009986
X011000Y003986
X020000Y009986
X020000Y003986
X011000Y004986
X020000Y004986
X011000Y005986
X020000Y005986
X011000Y006986
X011000Y010986
X020000Y006986
X020000Y010986
T104
X009000Y006986
X014000Y007986
X009000Y010986
X014000Y011986
T105
X004000Y001986
X004000Y009986
X004000Y007986
X004000Y005986
X004000Y011986
X004000Y003986
T00
M30
